00000000000000000000000000000000000000000000000000000000000000000000000000000000000000000000000000000000000000000000000001111000000000000000000
00000000000000000000000000000000000000000000000000000000000000000000000000000000000000000000000000000000000000000000000000110000000000000000000
00000000000000000000000000000000000000000000000000000000000000000000000000000000000000000000000000000000000000000000000001111000000000000000000
00000000000000000000000000000000000000000000000000000000000000000000000000000000000000000000000000000000000000000000000001111000000000000000000
00000000000000000000000000000000000000000000000000000000000000000000000000000000000000000000000000000000000000000000000001111000000000000000000
00000000000000000000000000000000000000000000000000000000000000000000000000000000000000000000000000000000000000000000000000110000000000000000000
20000000000000000000000000000000000000000000000000000000000000000000000000000000000000000000000000000000000000000000000001111000000000000000000
10000000000000000000000000000000000000000000000002222200000000000000000000000000000000000000000000000000000000000000000001111000000000000000000
10000000000000000000000000000000000000000000000000000000000000000000000000000000000000000000000000000000000000000000000001111000000000000000000
10000000000000000000000000000000000000002222000000000000000000000000000000000000000000000000000000000000000000000000000000110000000000000000000
10000000000000000000000000000000000000000000000000000000000000000000000000000000000000000000000000000000000000000000000011110000000000000000000
10000000000000000000000000000000000000000000000000000000000000000000000000000000000000000000000000000000000000000000000001111000000000000000000
12200000000000000022000000220000022220000000000000000000022222202002000200002000002000000200000002000000000000000000000001111000000000000000002
11122222222222222211000022112000000000000000000000000000000000000000000000000000000000000000000000000000000000000000000000110000000000000000001
11111111111111111111000011111000000000000000000000000000000000000000000000000000000000000000000000000000000000000000000001111000000000000000001
11111111111111111111000001100000000000000000000000000000000000000000000000000000000000000000000000000000000000000000000001111000000000000000001
11111111111111111111000001000000000000000000000000000000000000000000000000000000000000000000000000000000000000000000000001111000000000000000001
11111111111111111111000001000000000000000000000000000000000000000000000000000000000000000000000000000000000000000000000000110000000000000000001
11111111111111111111000000000000000000000000000000000000000000000000000000000000000000000000000000000000000000000000000001111000000000000000001
11111111111111111111222222222222222222222222222222222222222222200000000000000000000000000000000002222222222222222222222222222000000002222222221