     11111111
     10000001
     10000001          11111111
     10000001          10000001
     10000001111111111110000001111111
     10000000000000000000000000000001
     10000000000000000000000000000001
     11111000000000011110000001111001
         100000000001  10000001  1001
         100000000001  11100111 110011
         100000000001  111001111100001
         111110011111  100000000000001
             1001      100000000000001
1111         1001      111001111100001
1001         1001        1001   110011
1001         1001111111111001    1001
1001111111111100110000001100111111001
1000000000000000000000000000000000001
1400000000000000000000000000000000001
1110011111100111000001100111111100111
11100111  1001 11001111001    110011
10000001  1001  1001  1001    100001
10000001  1001  1001  1001    100001
10000001  1001 110011 1001    100001
10000001  10011100001 1001    100001
10000001  10000000001 1001    100001
10000001  10000000001 1001    100001
11111111  11111100001 1001    111111
               111111 1001
                      1111                                                           
