11111111111111111111
10200000110001100001
10022000110201100001
10200000110001100001
11111111111+11110011
               1001
11111111111-11112011
10000000000000000001
10000020000000000201
10002020000020000001
10020000112000000021
10000000110000000001
12004000110002000001
11111111111111111111
