11111111111
10000002010
10020000010
1+00000000*
10000020010
1020/000010
11111111111
















1111111111
14000200-1
1111111111
